........:....:...............................................-.....................
.#@-:@+..++@@..@@@@@+@@%@@+***@.%@@....:.@+.:@*..-#.::....*..:@..-@=.-*:#@-::...=@.
.-.:=:@#.+@:..@@#%.%@.....+-@@@#+:@@@#=@*.+=.@*.=@%=%@@@@@@@..*@@+-..%%@#@+@@**=...
.-++%=.:@*.=@@:.@-.-.-#:@@@#*:+@....*@@.#@@:.@@::%%-%-..:::::=....-.%*:..+:..-@@@:.
.:::-@*=-%*...@@..#%:*#*%#@%%#:.#@@@..*@=...:*%@=@@.=@.:#@@@:=#:@=..:.%%.#*-#=::%@.
.=:@.:#@*.@@@@+.++-%=@#:%%@@--@@=..:@@@-@+.....%%%@..#-.....#@@:@::@@@@:.*@:@*##+=.
.+:*@@..%...:..:@@:#:.-.@%+...............=@#@=*@@@-%@@.#:..:..*%.:::@@-.:..+.:%*:.
.@*%@.%@-@*.:#@@..:@=.@@@+#@..:@@@@@@@@==@=-@.:@..:@::@@@@.=%=:=%@@@..:..@:=#*..+#.
.@..:....=@%+:#@%#:#%#*@@@@#.@@*-=::::===%::++*@@:-..#:.@@-:##::+-:--@*.=@.#@@#..-:
..:...%@@@@@@#:=@@*=+@=@....:@@%::-+:..:@+-:.......::..@@@@=@@@@%%#=*#+#@@.:#-:..#.
:@@%@@%....-%@--+:@@%@@-#*@@@%@@%@@@@@@@=::@@@@@@@@@#@..=@*:%=-+%#*#%@%-:::@@@@@*@.
.=*-:+-#@@@#:*@%#@*@.::.-.@+-:=+@@@@@@@@@@@@@@@@@@@:+@:.:+@@#:*#@#%==-=@@%@%:*+:#%.
.#@@-@@@%@@@@+*:+*..@#--:%@@@@@@@@*-::::.............@@.::%*#==:=+@@%##+**#@*+**#..
:+:+.+#@=....@**=@@.=..:@@@@@@*...:::::::::...........@@.:*:*@@*#*:.#+%**=-+@@@%::.
.@@@=-@..%@@+=+@%:+%+*#@+*@*...:::::--:::::----:::::..+@-=@%.:%@@@@@#+#%%#+=+.:#+*.
:-+@@@=:@@::=@*@@%::*##@%@@:.::----::::::::::::::::::.%#=:+%@%:==+#*%-=@+%@@@%=:*%.
=@@@@..::*@@%@@:+.-*=@@@@@@=:::::::.:..:::.........::..:@@:%@@*%#*%@@@**@@+:-*@@+:.
.++..-@@@:.#@.-..#@@@@:..@@.::..........:::....:::......@#*%##%%%@+-=#**#-=*@+-%@@.
.@@#@-:+@@@#..:@+:.-.+@@*%@....@@@@@@=....-@@@@@%@@@@@%.@@@@@*=@##+#=*%*@@@#-=*+=*.
..+@@@...:@@@@@+@@=..::*@@@#@@*...:::@@@@@@#-%%@@@@@=@:.@:...#%#+#%@@..@*==%@@=+%#.
.+.:..*@@:....*@*..@--%%..@=*.@@*@@@@@*@..@:#@@::....#....:.@.@%+#:+@@@%@@%=*@@*-#.
:@+::*@+.:.@@@@*.%@#==@:@.:.@....::-:.=:..-@.....:...@...@@..%@##+=%%*::+*@@%-=%#*.
.:@@@+==@@=..@%=*-%@**--@.@.:+.......:@....:@.:....@#..:.:@:.@::@@@%+*@%#%%=+@@**@:
.++%++:=+=@@+..-@@%:....:=@.::*@@@@@##:.....-%%*=::....::=...@@@%@@@%%###*+%@#+@#*:
....+@:....*:.#@..=@@@@@:.:#::.....:=::=#--#:-=@+::::::-....@@++%@@@@@@@#%@%@@@*#@.
.=@@...@@...#@..@@:..@+.=....:=-=-+:.-@@%@@@:...:@#%@@=:.@@@@#@@@*.-@@@@@@@:@@@@@@*
.*...:@@:.@:.:@@..@@..+%@@@@#.:::::..::.::......*-:--=+..@@+.:-..:@....:.:@-....:+.
...@@%-:..@@..@@@..@@=:#=@@@@.=-+=@@@@@@@@@@@@@@@@-.:==..%:#@@@@@:.+@@@@@@...*@-...
.@@..+@+:.@@@.:@@@:*@@@@@%:.:.::::#*:+=::........=-:*+..@@%%@@*=:.*@@%@%@@...@@@:..
.#@@@@-%+:@@@..@:#%:+#*%:.+@@#.:::=:::-#@@@@@+::::+--:.#@@@@@@@@%@@*#**@@@..%@@-@..
..=...@@@-:#.-@@@=@@+=:@.:.:@@@...:=..............::#@-@@#=@*=@::@@%%@@@@@..@*@@@..
.++=.=..@=:@@#=*@#*#*@%@.%@%@@@@@.::::::.:....:%=@@@-.:..@@@@@@@@@##**=-+@.%@#+*@@.
:@@@%%=++%-+@#*+*%%#+*%@.:#@@@@@#@#.@@@@@@@@@@@@@*-..:@@-.*@@:.*@@@#**-.=@@@%=@+*#:
.#*.@#=+.=:=@*#*%#%%%=*@=%@@@@@:-@@...::=-:--::::...@@@@=:..@@@@@%@%#@%@@@#%*=%@#+.
.+.:@+=@@@++@+@#::@@%#+@%#*=%..%@=@:.:-::=+-::::..*@@@==:#:@@..@@@@+*@#+@@%@%=#@++.
.@@#+@@#*%@*@+%*#@%###-***@#*@@@*#@@.::-=*=:::..:@@@@%+@@%-*:..:.:@@@@@-.%%%#-@@**.
.*::=-%:..%###@*%*.#+%@%@@@:::..*@*@#...:::...-@@@@@@%+*-#++=-==@%..*@@@@@#%%+++*@:
.@@@@%@#%@@++*%*#*:@@@*:..#*@@@@+@%@@@......%@@@@%*+#@@%@#%-@#:::+@=..-@@@@@@*++%*:
.*....=#+=#%++#%@@@@+*#@#*:....@@@@@@@@@:.@@@@@@@@@@@+-@:@@+%@@@#=*#%*:...@@@%@%+:.
.=@@@.=#@#+%*@@@=....+*@@@@@@@*#%#%#*@@@@@@@#+==:::::#%@@@*%#*=:-*@@%@###:..:@@@@*.
.@@=@@@#=@%@@@.:@@@@#:....-*%@@@@@@@%@:.*@%%@@@@@@%@@@@+**===*#@@@-.-+@@@@#:....@@+
.=@%%..-=%@@.:@*#@@@@@@@@=-::===@..@@@@@@@@@@.@=:@@%=:+*%#+*#@@@+:-%@@%=::*@@**:...
.@-@@@@@#@#:+%@+=+*+*%@@@@@@%*+*@@@@*++*###@@.%@@+*=#%@@#**#@##-=#@@=:+:=@*=*@@+::.
......:#%-:%#=@#=#%@##+=*%@@@@@@%#*##@@@@#@@@@@#+*%#%%%#+*==+#=+%@**@+-@@=+#=*=#@@+
..........=+*:::...:::-::.::+=++***#:-..*-+-:::----:::::.:..:..::.::..@:::::..:-+::
