1111111111111111
1010000000000001
11P0000001000001
101000000C100001
1000001001000001
100001E000000001
100000100000O001
1111111111111111
