1111111111111111
111CCCCCCCCCCCC1
11PCCCCCC1CCCCC1
1C1CCCCCCC1CCCC1
1CCCCC1CC1CCCCC1
1CCCC1ECCCCCCCC1
1CCCCC1CCCCOCCC1
1111111111111111
